
   R      720      460
NO       ./textures/xpm/BASIC/MARBFAC2.xpm
    SO ./textures/xpm/BASIC/MARBFAC3.xpm
WE ./textures/xpm/BASIC/MARBFACE.xpm
EA ./textures/xpm/BASIC/MARBLE3.xpm
S  ./textures/xpm/SPRITE_BAS.xpm
F ./textures/xpm/BASIC/FLOOR7_2.xpm 515
C ./textures/xpm/BASIC/CEIL1_2.xpm

        1111111111111111111111111
        1000000000110000003000001
        1011000001110000003000001
        1001000000000000000000001
111111111011000001110000000000001
100000000011000001110111111111111
11110111111111011100000010601
11110111111111011101010017951
11000000110101011100000013041
10003000000000001100020000801
10000000000000001101010010001
11000001110101011111011110N01
11110111 1110101 101111010001
11111111 1111111 111111111111