   R      720      460
NO       ./textures/xpm/BASIC/MARBFAC2.xpm
    SO ./textures/xpm/BASIC/MARBFAC3.xpm
WE ./textures/xpm/BASIC/MARBFACE.xpm
EA ./textures/xpm/BASIC/MARBLE3.xpm
S  ./textures/xpm/SPRITE_HAUT.xpm
F ./textures/xpm/BASIC/FLOOR7_2.xpm
C ./textures/xpm/BASIC/CEIL1_2.xpm

        1111111111111111111111111
        1000000000110000000000001
        1011002001110000200090001
        1001000000000080009000001
11111111101100200111000000000001
100000000011000001610111111111111
11110111111111011100000210001
11110111111111011101010010201
11000000110101011100000010001
10009000000000001100000000001
10009000000000001101013010001
11000001110101011101511110N01
11110111 1110101 131111010001
11111111 1111111 111111111111