R      720      460
NO ./textures/BASIC/MARBFAC2.xpm
SO ./textures/BASIC/MARBFAC3.xpm
WE ./textures/BASIC/MARBFACE.xpm
EA ./textures/BASIC/MARBLE3.xpm
S  ./textures/BASIC/SPRITE_HAUT.xpm
F 0,153,76
C 0,0,255

        1111111111111111111111111  
        1000000000110000000000001 
        1011002001110000200000001 
        1001000000000000000000001
111111111011002001110000000000001  
100000000011000001010111111111111
11110111111111011100000210001
11110111111111011101010010201 
11000000110101011100000010001
10000000000000001100000000001
10000000000000001101010010001 
11000001110101011101011110N01
11110111 1110101 101111010001
11111111 1111111 111111111111