R      720      460
NO ./textures/BASIC/MARBFAC2.xpm
SO ./textures/BASIC/MARBFAC3.xpm
WE ./textures/BASIC/MARBFACE.xpm
EA ./textures/BASIC/MARBLE3.xpm
S  ./textures/BASIC/SPRITE_HAUT.xpm
F ./textures/xpm/FLOOR7_2.xpm
C ./textures/xpm/CEIL1_2.xpm

        1111111111111111111111111  
        1000000000110000000300001 
        1011002001110000200000601 
        1061007000000000800000901
111111111011002001110000000030001  
130000000311000001010111111111111
11110111111111011105000210001
11110111111111911101010013231 
11000000110101011100000010001
10000000000000001100400000001
10090000000000001101013310001 
11000001110101011101011110N01
11110111 1110101 101111010001
11111111 1111111 111111111111