


SO ./BIGDOOR61.xpm


WE ./BIGDOOR62.xpm
EA ./textures/xpm/BASIC/MARBLE3.xpmBIGDOOR63.xpm


S      ./BIGDOOR64.xpm
F ./BIGDOOR65.xpm
C ./BIGDOOR66.xpm

11111111111111
10000000000001
10000000000000111111111
11111000000000000000001
    1000000000011111111
    100000000001
    100000000001     111111
    11111111000111111100001    111    111    1   1   1   1
    11111111000000000000001    1  1   1  1   1   1   1   1
           10000000000000011111111    1111   1   1   11111
           100000N000000001    1  1   1  1   1   1   1   1
     111111111000000000000001  11111111  1111111111111   1
    1000000000000000000000001
    1000000000000000000000001
    1000000111111111111110011
    10000001            10001
    1000000011111111    100001
    10000000000000011111111101
     1111111111111000000000001
                   11111100111
                         1001
                 111     1001 
                 1000111111001
                 1000000001111
                 100011111
		   111