R 1080 720
NO ./textures/xpm/BASIC/MARBFAC2.xpm
SO ./textures/xpm/BASIC/MARBFAC3.xpm
EA ./textures/xpm/BASIC/MARBLE3.xpm
WE ./textures/xpm/BASIC/MARBFACE.xpm
S ./textures/xpm/SPRITE_HAUT.xpm
C ./textures/xpm/BASIC/CEIL1_2.xpm
F ./textures/xpm/BASIC/FLOOR7_2.xpm

01111111111111111
10000000000000001
10200000200000201
10000000000000001
10002000200020001
10000000W00000001
10202020002020201
10000000000000001
10002000200200001
10000000000000001
10200000200002001
10000000000000001
11111111111111111